#####################
#..................#
#.###.#######.######.#
#.#...#.....#.######
#.#.#####.#.######.#
#.#.....#.#.......#
#.#####.#.###.#####
#.....#.....#####.#
#####################
#..................#
#####################
    H              S