##############
#............#
#.###.#######.#
#.#...#.....#.#
#.#.#####.#.###
#.#.....#.#...#
#.#####.#.###.#
#.....#.....#.#
#######.#####.#
#.............#
##############
